Welcome
An Interactive Fiction
Release 1 / Serial number 201208 / Inform 7 build 6M62 (I6/v6.33 lib 6/12N) SD

Port
You arrive safely to the port, and unto the island that your father spoke fondly of in the past. It is the closest thing on Earth to the garden of heaven, and you are fulfilling the dying wish of your father to be buried here. You carry your father's body, which is almost ready for burial. You must first follow the necessary steps in order to ensure his successful transtition to the afterlife. A Muhru to please the Gods. A Dalilu to express your gratitude. And finally, seek the purest spring water in the region, a miracle of the dry desert. Take the fresh springwater with you, and you must apply the white burial garment to your father's body.

>go north
Market
Busy marketplace, the heart of the island. The small alleyways are filled with families and their children. A vendor close to the temple path gives free muhru (offerings) to those who wish to bury their dead. A convienient gift, may she be blessed.

You can see a Muhru here.

>go north
Date Fields
You come acreoss several rows of date palms, as far as the eye can see. Close to the first few rows is a date press to make the island's famous date molases.

>no east
I only understood you as far as wanting to no.

>go nort
You can't see any such thing.

>go north
Hot Desert

>go east
Sahara

>go west
Hot Desert

>go west
Infertile Land

>go west
Western Beach

* * *

>go north
Date Fields
You come acreoss several rows of date palms, as far as the eye can see. Close to the first few rows is a date press to make the island's famous date molases.

>go north
Hot Desert
The land here seems empty and dry.

>go north
Wasteland
The land here seems empty and dry. However, the sounds of running springwater fill the air.

>go north
Spring
You have finally found the sacred spring. It is said to be the purest water in the region, and the best for holy rituals and cleansing. You have never seen such clean and pure water before. The tales of your father come to mind. You feel content that he will be bathed here before his journey to the afterlife.

You can see Freshwater and White Burial Garment here.

>go north
You can't go that way.

>take white burial garment
Taken.

>wear white burial garment
You put on White Burial Garment.

* * *

>go north
Market
Busy marketplace, the heart of the island. The small alleyways are filled with families and their children. A vendor close to the temple path gives free muhru (offerings) to those who wish to bury their dead. A convienient gift, may she be blessed.

You can see a Muhru here.

>go est
You can't see any such thing.

>go east
Temple
the smell of burnt herbs and the sounds of chants fill the air.

* * *

>go north
Market
Busy marketplace, the heart of the island. The small alleyways are filled with families and their children. A vendor close to the temple path gives free muhru (offerings) to those who wish to bury their dead. A convienient gift, may she be blessed.

You can see a Muhru here.

>take muhru
Taken.

>go west
Village Homes
You approach the main village of the island. The homes are built adjacent to one another, and their lack of doors indicate the closeness of the population: everyone considers each other family. The very first house on your right is the home of the preist. He keeps an open chest of dalilu for those who wish to offer special prayers at the Temple.

You can see a Dalilu here.

>take dalilu
Taken.

>go east
Market
Busy marketplace, the heart of the island. The small alleyways are filled with families and their children. A vendor close to the temple path gives free muhru (offerings) to those who wish to bury their dead. A convienient gift, may she be blessed.

>go north
Date Fields
You come acreoss several rows of date palms, as far as the eye can see. Close to the first few rows is a date press to make the island's famous date molases.

>go east
Vineyard
The great vineyard is said to be the blood and veins of the island.

>go north
Sahara
The land here seems empty and dry.

>go north
Arid Land

>go north
Palm Trees
You come across a beautiful green space, a huge contrast to the dry and infertile desert. You hear the sound of a stream. You could be close to water.

>go south
Arid Land

>go west
Wasteland
The land here seems empty and dry. However, the sounds of running springwater fill the air.

>go north
Spring
You have finally found the sacred spring. It is said to be the purest water in the region, and the best for holy rituals and cleansing. You have never seen such clean and pure water before. The tales of your father come to mind. You feel content that he will be bathed here before his journey to the afterlife.

You can see Freshwater here.

>take Freshwater
Taken.

* * *

>go north
Market
Busy marketplace, the heart of the island. The small alleyways are filled with families and their children. A vendor close to the temple path gives free muhru (offerings) to those who wish to bury their dead. A convienient gift, may she be blessed.

You can see a Muhru here.

>go east
Temple
You enter into the area of the Temple. The smell of burnt herbs and the sounds of chants fill the air. You father mentioned that the best of peoeple always prayed here, and were always given what they have asked. It is no wonder he wanted to be buried close to such a holy place.

You can see Temple Graveyard Door here.

>go inside
You can't go that way.

>go to Temple Graveyard Door
You can't see any such thing.

>open Temple Graveyard Door
It seems to be locked.

>go west
Market
Busy marketplace, the heart of the island. The small alleyways are filled with families and their children. A vendor close to the temple path gives free muhru (offerings) to those who wish to bury their dead. A convienient gift, may she be blessed.

You can see a Muhru here.

>go north
Date Fields
You come acreoss several rows of date palms, as far as the eye can see. Close to the first few rows is a date press to make the island's famous date molases.

* * *

>go north
Wasteland
The land here seems empty and dry. However, the sounds of running springwater fill the air.

>go north
Spring
You have finally found the sacred spring. It is said to be the purest water in the region, and the best for holy rituals and cleansing. You have never seen such clean and pure water before. The tales of your father come to mind. You feel content that he will be bathed here before his journey to the afterlife.

You can see White Burial Garment and Freshwater here.

>take White Burial Garment
Taken.

>go south
Wasteland
The land here seems empty and dry. However, the sounds of running springwater fill the air.

>go south
Hot Desert
The land here seems empty and dry.

>go south
Date Fields
You come acreoss several rows of date palms, as far as the eye can see. Close to the first few rows is a date press to make the island's famous date molases.

>go south
Market
Busy marketplace, the heart of the island. The small alleyways are filled with families and their children. A vendor close to the temple path gives free muhru (offerings) to those who wish to bury their dead. A convienient gift, may she be blessed.

You can see a Muhru here.

I beg your pardon?

>go west
Village Homes
You approach the main village of the island. The homes are built adjacent to one another, and their lack of doors indicate the closeness of the population: everyone considers each other family. The very first house on your right is the home of the preist.

>go east
Market
Busy marketplace, the heart of the island. The small alleyways are filled with families and their children. A vendor close to the temple path gives free muhru (offerings) to those who wish to bury their dead. A convienient gift, may she be blessed.

You can see a Muhru here.

>go east
Temple
You enter into the area of the Temple. The smell of burnt herbs and the sounds of chants fill the air. You father mentioned that the best of peoeple always prayed here, and were always given what they have asked. It is no wonder he wanted to be buried close to such a holy place.

You can see Temple Graveyard Door here.

>open Temple Graveyard Door
It seems to be locked.

>use White Burial Garment
That's not a verb I recognise.

>unlock Temple Graveyard Door
What do you want to unlock Temple Graveyard Door with?

>White Burial Garment
You unlock Temple Graveyard Door.

>go east
(first opening Temple Graveyard Door)

Temple Graveyard
Funnily enough, this is said to be the most peaceful place on the island. The deceased are also said to be in the best divine hands within these holy grounds.

You can see Temple Graveyard Door here.

* * *

>go north
Market
Busy marketplace, the heart of the island. The small alleyways are filled with families and their children. A vendor close to the temple path gives free muhru (offerings) to those who wish to bury their dead. A convienient gift, may she be blessed.

You can see a Muhru here.

>go west
Village Homes
You approach the main village of the island. The homes are built adjacent to one another, and their lack of doors indicate the closeness of the population: everyone considers each other family. The very first house on your right is the home of the preist. It would be rude not to say hello. Perhaps he can help you find a Dalilu for prayer at the burial.

"Hello my son, I know that which you seek. The Gods whispered to me your father's wishes, he will find his peace here. Seek the preistess of the Western Seaside, she will offer you the most sacred of Dalilu to chant and please the Gods. May the Gods be with you."

>talk
That's not a verb I recognise.

>talk to Preist
That's not a verb I recognise.

>say hello
(to Preist)
There is no reply.

* * *

>say hello
(to Preist)
There is no reply.

* * *

>go west
Southern Seaside
A great place to rest your head and reflect. The faint sounds of chanting can be heard. The Temple must be nearby.

>go north
You can't go that way.

>go west
You can't go that way.

>go east
Port
You arrive safely to the port, and unto the island that your father spoke fondly of in the past. It is the closest thing on Earth to the garden of heaven, and you are fulfilling the dying wish of your father to be buried here. You carry your father's body, which is almost ready for burial. You must first follow the necessary steps in order to ensure his successful transtition to the afterlife. A Muhru to please the Gods. A Dalilu to express your gratitude. And finally, seek the purest spring water in the region, a miricle of the dry desert. Use the Spring's freshwater to wash and clothe your father's body with the sacred white burial cloth.

>go north
Market
Busy marketplace, the heart of the island. The small alleyways are filled with families and their children. A vendor close to the temple path gives free muhru (offerings) to those who wish to bury their dead. A convienient gift, may she be blessed.

You can see a Muhru here.

>take Muhru
Taken.

>eat Muhru
That's plainly inedible.

>use Muhru
That's not a verb I recognise.

>go east
Temple
You enter into the area of the Temple. The smell of burnt herbs and the sounds of chants fill the air. You father mentioned that the best of peoeple always prayed here, and were always given what they have asked. It is no wonder he wanted to be buried close to such a holy place.

You can see Temple Graveyard Door here.

* * *

>open Temple Graveyard Door
It seems to be locked.

>go west
Market
Busy marketplace, the heart of the island. The small alleyways are filled with families and their children. A vendor close to the temple path gives free muhru (offerings) to those who wish to bury their dead. A convienient gift, may she be blessed.

>go west
Village Homes
You approach the main village of the island. The closeness of the houses and their lack of doors indicate the closeness of the population: everyone considers each other family. The very first house on your right is the home of the preist. He keeps an open chest of dalilu for those who wish to offer special prayers at the Temple.

You can see a Dalilu here.

>take dalilu
Taken.

* * *

>inventory
You are carrying:
  father body

>look
Port
You arrive safely to the port, and unto the island that your father spoke fondly of in the past. It is the closest thing on Earth to the garden of heaven, and you are fulfilling the dying wish of your father to be buried here. You carry your father's body, which is almost ready for burial. You must first follow the necessary steps in order to ensure his successful transtition to the afterlife. A Muhru to please the Gods. A Dalilu to express your gratitude. And finally, seek the purest spring water in the region, a miracle of the dry desert. Take the fresh springwater with you, and you must apply the white burial garment to your father's body.

>go north
Market
Busy marketplace, the heart of the island. The small alleyways are filled with families and their children. A vendor close to the temple path gives free muhru (offerings) to those who wish to bury their dead. A convienient gift, may she be blessed.

You can see a Muhru here.